border_size=1
usage=map

Ch          , Ch          , Ch          , Ch          , Rr          , Rr          , Rr          , Rr          , Rr          , Rr          , Rr          , Rr          , Rr          , Rr          , Rr          
Ch          , 2 Kh        , 3 Kh        , 4 Kh        , Rr          , Rr          , Rr          , Rr          , Rr          , Rr          , Rr          , Rr          , Rr          , Rr          , Rr          
Rr          , Rr          , Rr          , Rr          , Rr          , Rr          , Rr          , 1 Kh        , Rr          , Rr          , Rr          , Rr          , Rr          , Rr          , Rr          
Rr          , Rr          , Rr          , Gg^Ve       , Rr          , Gg^Ve       , Rr          , Gg^Ve       , Rr          , Gg^Ve       , Rr          , Gg^Ve       , Rr          , Rr          , Rr          
Rr          , Rr          , Rr          , Rr          , Rr          , Rr          , Rr          , Rr          , Rr          , Rr          , Rr          , Rr          , Rr          , Rr          , Rr          
Rr          , Rr          , Rr          , Rr          , Rr          , Rr          , Rr          , Rr          , Rr          , Rr          , Rr          , Rr          , Rr          , Rr          , Rr          
Rr          , Rr          , Rr          , Rr          , Rr          , Rr          , Rr          , Rr          , Rr          , Rr          , Rr          , Rr          , Rr          , Rr          , Rr          
Rr          , Rr          , Rr          , Gg^Ve       , Rr          , Gg^Ve       , Rr          , Gg^Ve       , Rr          , Gg^Ve       , Rr          , Gg^Ve       , Rr          , Rr          , Rr          
Rr          , Rr          , Rr          , Rr          , Rr          , Rr          , Rr          , Rr          , Rr          , Rr          , Rr          , Rr          , Rr          , Rr          , Rr          
Rr          , Rr          , Rr          , Rr          , Rr          , Rr          , Rr          , Rr          , Rr          , Rr          , Rr          , Rr          , Rr          , Rr          , Rr          
