border_size=1
usage=map

Gg          , Gg          , Gs^Fp       , Gg          , Gs^Fp       , Gg          , Gs^Fp       , Gg          , Gg          , Gg          , Gg          , Gg          , Gg          , Gg          , Rd          , Rd          , Gg          , Gg          , Gg          , Gs^Fp       , Hh          , Hh          , Gg          , Gg          , Gs^Fp       , Gg          , Gg          , Gs^Fp       , Gg          , Gg          
Gg          , Gg          , Gs^Fp       , Gg          , Gs^Fp       , Gg          , Gs^Fp       , Gg          , Gg          , Gg          , Gg          , Gg          , Gg          , Gg          , Rd          , Rd          , Gg          , Gg          , Gg          , Gs^Fp       , Hh          , Hh          , Gg          , Gg          , Gs^Fp       , Gg          , Gg^Vh       , Gs^Fp       , Gg          , Gg          
Gg          , Gg          , Gg          , Gg          , Gs^Fp       , Gg          , Gg          , Gs^Fp       , Gg          , Gs^Fp       , Gg          , Gs^Fp       , Gs^Fp       , Gg          , Rd          , Gg          , Gg          , Gg          , Gg          , Gs^Fp       , Hh          , Gs^Fp       , Gs^Fp       , Gs^Fp       , Gg          , Gs^Fp       , Gs^Fp       , Gs^Fp       , Gs^Fp       , Gs^Fp       
Gs^Fp       , Gs^Fp       , Gg          , Gg          , Gg          , Gg          , Gg          , Gg          , Gg          , Gg          , Gg          , Gg          , Gs^Fp       , Gg          , Rd          , Gg          , Gg          , Gg          , Gg          , Gs^Fp       , Hh          , Gs^Fp       , Hh          , Gg          , Gg          , Gs^Fp       , Gs^Fp       , Gs^Fp       , Gg          , Gg          
Gs^Fp       , Gs^Fp       , Gs^Fp       , Gg^Vh       , Gg          , Gs^Fp       , Gg          , Gg          , Ce          , Gg          , Gg          , Gg          , Gg^Vh       , Rd          , Rd          , Gg^Vh       , Gg          , Gg          , Gg          , Gg          , Gs^Fp       , Hh          , Gs^Fp       , Gg          , Gs^Fp       , Gg          , Gg          , Gs^Fp       , Gg          , Gg          
Gg          , Gg          , Gg          , Gs^Fp       , Gs^Fp       , Gg          , Gg          , Ce          , 5 Ke        , Ce          , Gg          , Gg          , Rd          , Rd          , Gg          , Rd          , Rd          , Gg          , Gg          , Gg          , Gg          , Gg          , Gs^Fp       , Hh          , Hh          , Hh^Vhh      , Gs^Fp       , Gg          , Gs^Fp       , Gs^Fp       
Gs^Fp       , Gs^Fp       , Gs^Fp       , Gs^Fp       , Gs^Fp       , Gg          , Gg          , Ce          , Ce          , Ce          , Rd          , Rd          , Gs^Fp       , Gg          , Hh          , Gg          , Rd          , Gg          , Gg          , Gs^Fp       , Gs^Fp       , Gg          , Gg          , Gg          , Gs^Fp       , Hh          , Hh          , Gs^Fp       , Gs^Fp       , Gs^Fp       
Gg          , Gg          , Gs^Fp       , Gg          , Gg          , Gg          , Gg          , Gg          , Gg          , Gg          , Rd          , Gg          , Gg          , Hh          , Gs^Fp       , Gg          , Rd          , Gg          , Gg          , Gg          , Gs^Fp       , Gg          , Gg          , Gg          , Gg          , Gs^Fp       , Gs^Fp       , Gs^Fp       , Gs^Fp       , Gs^Fp       
Gs^Fp       , Gs^Fp       , Gs^Fp       , Gg          , Gs^Fp       , Gg          , Gg          , Gg          , Gg          , Gg          , Rd          , Gg          , Gs^Fp       , Hh          , Gs^Fp       , Gg          , Rd          , Gg          , Gg          , Gg          , Gg          , Gg          , Gg          , Gg          , Gg          , Gg          , Gg          , Gg          , Gg          , Gg          
Gs^Fp       , Gs^Fp       , Gg          , Gs^Fp       , Gg          , Gg          , Gg          , Gs^Fp       , Gs^Fp       , Gg^Vh       , Rd          , Gg          , Gg          , Hh          , Gg          , Gg          , Rd          , Gg          , Gg          , Gg          , Gg          , Gg          , Ce          , Ce          , Ce          , Gg          , Gg          , Gg          , Gg          , Gg          
Gg          , Gg          , Gs^Fp       , Gs^Fp       , Gs^Fp       , Gs^Fp       , Gs^Fp       , Hh          , Gs^Fp       , Gs^Fp       , Rd          , Gg          , Gg          , Hh          , Gg          , Gg^Vh       , Rd          , Gg          , Gg          , Gg          , Gg          , Gg          , Ce          , 6 Ke        , Ce          , Gg          , Gg          , Gg          , Gg          , Gg          
Gg          , Gg          , Gg          , Gs^Fp       , Gg          , Gs^Fp       , Gg          , Gg          , Gg          , Gg          , Rd          , Gg          , Gg          , Gg          , Gg          , Gg          , Rd          , Hh          , Rd          , Gg          , Gg          , Gg          , Gg          , Ce          , Rd          , Gg          , Gg          , Gg          , Gg          , Gg          
Gg          , Gg          , Gg          , Gs^Fp       , Gs^Fp       , Gg          , Rd          , Gs^Fp       , Rd          , Rd          , Gs^Fp       , Gs^Fp       , Hh          , Hh          , Gg          , Gg          , Gg          , Rd          , Hh          , Rd          , Rd          , Gg^Vh       , Rd          , Gg          , Rd          , Gg          , Gg          , Gg          , Gg          , Gg          
Gs^Fp       , Gs^Fp       , Gs^Fp       , Hh          , Gg          , Rd          , Hh          , Rd          , Gs^Fp       , Gg          , Hh          , Hh          , Gg          , Gg          , Gg          , Gg          , Gg          , Gg          , Gg          , Gg          , Gg          , Rd          , Gg          , Rd          , Gg^Vh       , Rd          , Rd          , Gg          , Gg          , Gg          
Gg          , Gg          , Gs^Fp       , Gg          , Gg          , Rd          , Hh          , Gg          , Hh          , Gs^Fp       , Gg          , Gs^Fp       , Gs^Fp       , Gs^Fp       , Gg          , Gg          , Gg          , Gg          , Gg          , Gg          , Gg          , Gg          , Gg          , Gg          , Gg          , Gg          , Rd          , Gg          , Gg          , Gg          
Gg          , Gg          , Gg          , Gg          , Hh          , Rd          , Rd          , Hh          , Gs^Fp       , Hh          , Gg          , Gg          , Gg          , Gg          , Gg          , Gg          , Gg          , Gg          , Gg          , Gg          , Gg          , Gg          , Gg          , Gg          , Gg          , Gg          , Rd          , Gg          , Gg          , Gg          
Hh          , Hh          , Hh          , Hh          , Gg          , Gs^Fp       , Gs^Fp       , Rd          , Rd          , Gg          , Gs^Fp       , Gg          , Gg          , Gg          , Gg          , Gg          , Gg          , Gg          , Gg          , Gg          , Gg          , Gg          , Gg          , Gg          , Gg          , Gg          , Rd          , Gg          , Gg          , Gg          
Gs^Fp       , Gs^Fp       , Hh^Vhh      , Gg          , Gg          , Gg          , Gg          , Gg          , Rd          , Gg          , Gg          , Gg          , Gg          , Gg          , Gg          , Gg          , Ww          , Gg          , Ww          , Gg          , Ww          , Gg          , Gg          , Gg          , Gg          , Gg          , Gg          , Rd          , Gg          , Gg          
Hh          , Hh          , Gg          , Gs^Fp       , Gs^Fp       , Gs^Fp       , Hh          , Gg          , Rd          , Gg          , Gg          , Gg          , Gg          , Gg          , Ww          , Ww          , Ww          , Ww          , Ww          , Ww          , Ww          , Ww          , Ww          , Gg          , Gg          , Gg          , Gg          , Rd          , Ww          , Ww          
Gs^Fp       , Gs^Fp       , Gs^Fp       , Hh          , Hh          , Hh          , Gs^Fp       , Gs^Fp       , Hh          , Rd          , Rd          , Gg          , Gg          , Ww          , Ww          , Kh          , Ch          , Ch          , Ch          , Ch          , Ch          , Ww          , Kh          , Ww          , Ww          , Gg          , Ww          , Ww^Bw|      , Gg          , Gg          
Hh          , Hh          , Gg          , Gs^Fp       , Gg          , Gs^Fp       , Gs^Fp       , Gs^Fp       , Hh          , Hh          , Rd          , Gg          , Gg          , Ww          , Ch          , Ch          , Rr          , Rr          , Rr          , Rr          , Gg^Ve       , Ch          , Ch          , Ww          , Ww          , Ww          , Gg          , Rd          , Gg          , Gg          
Gs^Fp       , Gs^Fp       , Gg          , Gs^Fp       , Gg          , Gg          , Rd          , Hh          , Hh          , Rd          , Gg          , Gg          , Gg          , Ww          , Kh          , Ch          , Rr          , Gg^Ve       , Rr          , Rr          , Rr          , Rr          , Ch          , Ch          , Ww          , Ww          , Gg          , Rd          , Gg          , Gg          
Rd          , Rd          , Rd          , Rd          , Rd          , Rd          , Gg          , Rd          , Rd          , Rd          , Gg          , Gg          , Ww          , Ww          , Ww          , Ch          , Ch          , Rr          , Ch          , Ch          , Ch          , Rr          , Rd          , Kh          , Ww          , Ww          , Gg          , Rd          , Gg          , Gg          
Gg          , Gg          , Gg          , Gs^Fp       , Gg          , Gg          , Gg          , Gg          , Gg^Vh       , Rd          , Gg          , Gg          , Ww          , Gg          , Ww          , Ch          , Ch          , Rr          , Ch          , 2 Kh        , Ch          , Rr          , Re          , Re          , Re          , Ww          , Gg          , Rd          , Gg          , Gg          
Gg          , Gg          , Gg          , Gs^Fp       , Gg          , Gg          , Gg          , Gg          , Gg          , Rd          , Rd          , Gg          , Gg          , Ww          , Ww          , Re          , Re          , Chr         , Chr         , Rd          , Rd          , Rr          , Re          , Chr         , Re          , Ww          , Gg          , Rd          , Gg          , Gg          
Gg          , Gg          , Gg          , Gs^Fp       , Gg          , Gg          , Gs^Fp       , Gg          , Gg          , Gg          , Gg          , Rd          , Rd          , Re          , Re          , Ww          , Ww          , Re          , Re          , Chr         , Re          , Rd          , Chr         , Re          , Re          , Gg          , Gg          , Rd          , Gg          , Gg          
Gg          , Gg          , Gs^Fp       , Gg          , Gg          , Gs^Fp       , Gg          , Gg          , Gg          , Gg          , Re          , Re          , Rd          , Gg          , Gg          , Re          , Re          , Ww          , Ww          , Re          , Re          , Re          , Re          , Re          , Re          , Gg          , Gg          , Rd          , Gg          , Gg          
Gg          , Gg          , Gs^Fp       , Gs^Fp       , Gg          , Gs^Fp       , Gg          , Gg          , Ce          , Ce          , Ce          , Re          , Rd          , Gg          , Gg          , Re          , Re          , Gg          , Ww          , Gg          , Gg          , Re          , Rd          , Gg          , Gg          , Gg          , Rd          , Rd          , Gg          , Gg          
Gg          , Gg          , Gs^Fp       , Gs^Fp       , Gs^Fp       , Gg          , Gg          , Gg          , Ce          , 3 Ke        , Ce          , Re          , Rd          , Re          , Re          , Gg          , Gg          , Gg          , Ww          , Ww          , Gg          , Gg          , Rd          , Gg          , Rd          , Rd          , Gg          , Gg          , Gg          , Gg          
Gg          , Gg          , Gs^Fp       , Gg          , Gs^Fp       , Gs^Fp       , Gs^Fp       , Gg          , Gg          , Ce          , Gg          , Rd          , Gg          , Re          , Re          , Re          , Re          , Gg          , Ww          , Gg          , Re          , Gg          , Rd          , Rd          , Gg          , Gg          , Re          , Gg          , Gg          , Gg          
Gg          , Gg          , Gg          , Gs^Fp       , Gg          , Gs^Fp       , Gg          , Gg          , Gg          , Re          , Rd          , Rd          , Gg          , Gs^Fp       , Gg          , Re          , Ww          , Ww          , Gg          , Re          , Re          , Re          , Rd          , Gg          , Gg          , Re          , Gg          , Gg          , Gg          , Gg          
Gg          , Gg          , Ww          , Ww          , Ww          , Gg          , Ww          , Gg          , Gg          , Gg          , Rd          , Gg          , Gg          , Gs^Fp       , Ww          , Ww          , Gg          , Gg          , Gg          , Gg          , Gg          , Rd          , Gg^Vh       , Re          , Re          , Gg          , Gg          , Gg          , Gg          , Gg          
Ww          , Ww          , Gs^Fp       , Ww          , Ww          , Ww          , Ww          , Ww          , Rd          , Rd          , Gg          , Gg          , Ww          , Ww          , Gg          , Gg          , Gg          , Gg          , Gg          , Gg          , Rd          , Rd          , Ce          , Gg          , Gg          , Gg          , Gg          , Gg          , Gs^Fp       , Gs^Fp       
Gs^Fp       , Gs^Fp       , Gs^Fp       , Gs^Fp       , Gs^Fp       , Gg          , Gs^Fp       , Ww          , Ww^Bw|      , Gg          , Ww          , Ww          , Ww          , Gg          , Gg          , Gg          , Gg          , Gg          , Rd          , Rd          , Re          , Ce          , 4 Ke        , Ce          , Gg          , Gg          , Gg          , Gg          , Gs^Fp       , Gs^Fp       
Gs^Fp       , Gs^Fp       , Gg          , Gs^Fp       , Gs^Fp       , Gs^Fp       , Gg          , Gg          , Rd          , Ww          , Ww          , Ww          , Gs^Fp       , Gg          , Gg          , Gg          , Rd          , Rd          , Gg^Vh       , Gg          , Re          , Ce          , Ce          , Ce          , Gg          , Gg          , Gg          , Gs^Fp       , Gg          , Gg          
Gg          , Gg          , Gg          , Gg^Vh       , Gs^Fp       , Gs^Fp       , Gg          , Rd          , Gg^Vh       , Gg          , Ww          , Gs^Fp       , Gs^Fp       , Gg^Vh       , Rd          , Rd          , Gg          , Gg          , Gg          , Re          , Gg          , Gg          , Gg          , Gg          , Gg          , Gg          , Gs^Fp       , Gg          , Gg          , Gg          
Gs^Fp       , Gs^Fp       , Gs^Fp       , Gs^Fp       , Gg          , Gg          , Gg          , Rd          , Gg          , Gg          , Ww          , Gg          , Rd          , Rd          , Gg          , Gg          , Gg          , Gg          , Gg          , Gg          , Gg          , Gg          , Gg          , Gs^Fp       , Gs^Fp       , Gs^Fp       , Gg          , Gs^Fp       , Gs^Fp       , Gs^Fp       
Gs^Fp       , Gs^Fp       , Gg          , Gg          , Ce          , Gg          , Gg          , Rd          , Rd          , Gg          , Rd          , Ww^Bw/      , Ww          , Gg          , Gs^Fp       , Gg          , Gg          , Gg          , Gs^Fp       , Gg          , Gg          , Gg^Vh       , Gg          , Gs^Fp       , Gs^Fp       , Gs^Fp       , Gs^Fp       , Gg^Vh       , Gg          , Gg          
Gs^Fp       , Gs^Fp       , Gg          , Ce          , 1 Ke        , Ce          , Gg          , Gg^Vh       , Rd          , Rd          , Gg          , Gg          , Gg          , Ww          , Ww          , Gs^Fp       , Gs^Fp       , Gg          , Gg          , Gs^Fp       , Gs^Fp       , Gs^Fp       , Gg          , Gg          , Gg          , Gg          , Gs^Fp       , Gg          , Gg          , Gg          
Gs^Fp       , Gs^Fp       , Gg          , Ce          , Ce          , Ce          , Rd          , Rd          , Gg          , Gg          , Gg          , Gg          , Gs^Fp       , Gg          , Ww          , Gs^Fp       , Ww          , Gs^Fp       , Gg          , Gg          , Gs^Fp       , Gg          , Gg          , Gg          , Gs^Fp       , Gs^Fp       , Gs^Fp       , Gs^Fp       , Gs^Fp       , Gs^Fp       
Gg          , Gg          , Gg          , Gg          , Rd          , Rd          , Gg          , Gs^Fp       , Gs^Fp       , Gg          , Gs^Fp       , Gs^Fp       , Gs^Fp       , Gg          , Gs^Fp       , Ww          , Ww          , Gg          , Gg          , Gs^Fp       , Gg          , Gs^Fp       , Gs^Fp       , Gs^Fp       , Gg          , Gg          , Gs^Fp       , Gs^Fp       , Gs^Fp       , Gs^Fp       
Gg          , Gg          , Gg          , Gg          , Rd          , Rd          , Gg          , Gs^Fp       , Gs^Fp       , Gg          , Gs^Fp       , Gs^Fp       , Gs^Fp       , Gg          , Gs^Fp       , Ww          , Ww          , Gg          , Gg          , Gs^Fp       , Gg          , Gs^Fp       , Gs^Fp       , Gs^Fp       , Gg          , Gg          , Gs^Fp       , Gs^Fp       , Gs^Fp       , Gs^Fp       
